wwwwwwwwwwwww
w........w..w
w...........w
w...A...w..ww
www.w...wwwww
w.......w...w
w.T........ww
w.........cww
wwwwwwwwwwwww